11111111111
1E0000P00C1
100000N0001
11111111111
