11111111111
1E0000P0001
10000000001
10000000001
10N000N00C1
11111111111
