11111111111
1E1000P0001
10000000001
100E0000011
10N000N01C1
11111111111
