1111111111111111
1E0000C00000P0N1
1111111111111111
