11111111111
1E0000P00C1
100000C0001
100C0000001
10N000N0001
11111111111
