1111111111111
10010000P0001
1000011111001
10E11000C0P01
1111111111111
