1111111111111
10000000000P1
11E1000000001
1010000C00001
1111111111111
