1111111111111
10010000P0001
1000011111001
10E11000C0001
1111111111111
