11111111111111111111
1C00C0000C0000000C11
1C10000C011000000111
11111000000000000011
110C0000C00100N00011
110C0000C00110000011
110C0010C00110001011
110C0E10000110000011
110C0010C00110N00011
11101010000110000011
110C1000C00110000P11
11111111111111111111
