1111111111111
1C00C0000C0E1
1C1000PC01111
1111100000001
110C0000C0011
110C0000C0011
110C0010C0011
110C0010C0011
110C0010C0011
110C0010C0011
110C0010C0011
1111111111111
